Level 18: Last Resort
2
6
0
Sometimes robots resort to violence.
00000000000000000000
06666666666666666660
06666666666666666660
06666666666666666660
06666666666666666660
06666666666666666660
06666666666666666660
06666666666666666660
06666666666666666660
0..............{.{.0
0s.............{.{f0
0..............{.{.0
06666666666666666660
06666666666666666660
06666666666666666660
06666666666666666660
06666666666666666660
06666666666666666660
06666666666666666660
00000000000000000000

