Level 01: The Redirection Bot
1
1
1
Welcome! Launch the train down to begin. Transform the Generic Bot into a Redirection Bot to navigate your Robotrain to the finish. Click the help icon for more info.
00000000000000000000
05555550.s.055555550
05555550...055555550
05555550...055555550
05555550...055555550
05555550...055555550
05555550...055555550
05555550...055555550
05555550...000000000
05555550...........0
05555550.>.........0
05555550...........0
05555550...00000...0
05555550...05550...0
05555550...05550...0
0555555000005550.f.0
05555555555555500000
05555555555555555550
05555555555555555550
00000000000000000000

