Level 25: The Decoy Bot
1
9
1
The Decoy Bot is designed to attract Alien Bots. Use this bot when you can't avoid them or fight them!
00000000000000000000
0666660..s...0666660
0666660......0666660
0666660......0666660
0666660......0666660
0666660......0666660
0666660......0666660
0666660......0666660
0666660......0666660
0666660......0666660
0666660......0666660
0666660......0666660
0666660......0666660
0666660..[...0666660
0666660..[...0666660
0666660..[...0666660
0666660..f...0666660
0666660......0666660
0666660......0666660
00000000000000000000

