Level 23: Lava River
6
8
0

00000000000000000000
066666666.....1....0
066666666.....1.r0.0
0s......6.....0660.0
0.......6.....0660.0
0.......6.....0000.0
0.......6......66..0
0.......6......66660
0.......666666666660
0............6....v0
0............6.....0
0.........6666.....0
0.........6666.....0
0.........6.......v0
0.........6........0
0.........6....>..v0
06666666666.....0QQ0
066666..........0..0
0.....>..>......0.f0
00000000000000000000

