Level 04: Switches
1
3
0
A switch opens a laser gate of the same color. Push a switch by having any bot step on it. Remember, you can launch a bot off the train in any direction. Also note that it's possible, but not necessary, to launch a plain Generic Bot.
00000000000000000000
055555550.s.05555550
055555550...05555550
055555550...05555550
055555550...05555550
055555550.r.05555550
055555550...05555550
055555550...05555550
000000000QQQ05555550
0...........05555550
0...g.......05555550
0...........05555550
000000000...05555550
055555550...05555550
055555550...05555550
055555550...05555550
055555550WWW05555550
055555550...05555550
055555550.f.05555550
00000000000000000000

