Level 24: Zelda Style
6
8
0

00000000000000000000
0s................v0
0..................0
0..................0
0..................0
0..................0
0......111111111...0
0......444444444...0
0.111..444434444...0
0.1>1..4443f3444...0
0.111..444434444...0
0......444444444...0
0..................0
0..................0
0>................<0
05555555555555555550
05555555555555555550
05555555555555555550
05555555555555555550
00000000000000000000

