Level 14: No More Mr. Nice Guy
5
6
0

00000000000000000000
0s...........O.g..v0
0............O....<0
0............0000000
0............5555550
0............5555550
0............5555550
0......5555555555550
0......555.........0
0......555.^......v0
0......555.........0
0......555.........0
0555555555........v0
0..................0
0>......o..........0
0.................v0
0...............0WW0
0...............0..0
0...............0.f0
00000000000000000000

