Level 15: Seriously
5
6
0

00000000000000000000
04>44444.......v...0
04444444.11111.....0
04444444..........b0
04444444...000111000
0....444...........0
0.s..444444>444v4440
0....444444444444440
0....444444^444<4440
00000000000000AAA000
0...11.5555.......v0
0..r11.5555.....<..0
0...11.5555.....^.<0
00001100000000.....0
0...11.............0
0..................0
0v.............<...0
0QQQ0000000000000000
0f..0..............0
00000000000000000000

