Level 20: Te Llama Tazama
6
7
0

00000000000000000000
0s.............v0z30
0...............0.30
0...............0..0
0...............0..0
0..................0
0............3.....0
0............3....<0
0..55555555555555550
0..5..............v0
0..5...............0
0..5.............3.0
0..5...............0
0..5...............0
0..555.............0
0..555^...........<0
0..55555555555555550
0ZZ05555555555555550
0f.05555555555555550
00000000000000000000

