Level 21: Onward, Team Robot
5
7
0

00000000000000000000
0s..3.........1....0
0...3.........1....0
0.............1....0
0..........3331....0
0...3........11....0
0...3....666111..b.0
0.............166660
0............v166660
0..............66660
0..................0
0..................0
0........44444444440
0........44444444440
0>...........6666660
0........44444444440
0........44444444000
0........44......B.0
0>.......44..>...Bf0
00000000000000000000

